11111111111111111111
1E000000000000000001
10000000000000000001
1C001111111111111101
1010000001C001000001
1P100000011100000001
11111111111111111111